id	ismarine	cvgt
Galaxias_platei	False	True
Galaxias_neocaledonicus	False	True
Galaxias_brevipinnis	False	True
Galaxias_gollumoides	False	True
Galaxias_paucispondylus	False	True
Galaxias_maculatus	False	True
Neochanna_burrowsius	False	True
Galaxias_zebratus	False	True
Aplochiton_zebra	False	True
Lovettia_sealii	False	True
Pamphorichthys_scalpridens	False	True
Pamphorichthys_minor	False	True
Pamphorichthys_hollandi	False	True
Pamphorichthys_araguaiensis	False	True
Pamphorichthys_hasemani	False	True
Limia_heterandria	False	True
Poecilia_caucana	False	True
Poecilia_latipunctata	False	True
Poecilia_vivipara	False	True
Poecilia_wingei	False	True
Poecilia_reticulata	False	True
Poecilia_parae	False	True
Cnesterodon_decemmaculatus	False	True
Cnesterodon_hypselurus	False	True
Xiphophorus_malinche	False	True
Xiphophorus_hellerii	False	True
Jenynsia_onca	False	True
Anableps_anableps	False	True
Lucania_goodei	False	True
Llanolebias_stellifer	False	True
Gnatholebias_zonatus	False	True
Austrofundulus_limnaeus	False	True
Austrofundulus_transilis	False	True
Austrofundulus_leohoignei	False	True
Terranatos_dolichopterus	False	True
Renova_oscari	False	True
Pterolebias_longipinnis	False	True
Trigonectes_rubromarginatus	False	True
Trigonectes_balzanii	False	True
Neofundulus_paraguayensis	False	True
Anablepsoides_iridescens	False	True
Anablepsoides_ophiomimus	False	True
Anablepsoides_hartii	False	True
Melanorivulus_punctatus	False	True
Melanorivulus_pictus	False	True
Melanorivulus_violaceus	False	True
Cynodonichthys_tenuis	False	True
Cynodonichthys_magdalenae	False	True
Pituna_poranga	False	True
Maratecoara_formosa	False	True
Atlantirivulus_santensis	False	True
Atlantirivulus_haraldsiolii	False	True
Laimosemion_mahdiaensis	False	True
Rivulus_cylindraceus	False	True
Rivulus_roloffi	False	True
Kryptolebias_caudomarginatus	False	True
Kryptolebias_marmoratus	False	True
Austrolebias_bellottii	False	True
Austrolebias_adloffi	False	True
Austrolebias_alexandri	False	True
Hypsolebias_magnificus	False	True
Hypsolebias_flammeus	False	True
Hypsolebias_flavicaudatus	False	True
Ophthalmolebias_bokermanni	False	True
Ophthalmolebias_constanciae	False	True
Nematolebias_whitei	False	True
Campellolebias_brucei	False	True
Epiplatys_singa	False	True
Epiplatys_lamottei	False	True
Epiplatys_bifasciatus	False	True
Scriptaphyosemion_guignardi	False	True
Scriptaphyosemion_banforense	False	True
Callopanchax_occidentalis	False	True
Aphyosemion_bivittatum	False	True
Aphyosemion_australe	False	True
Aphyosemion_ahli	False	True
Aphyosemion_ocellatum	False	True
Aphyosemion_hofmanni	False	True
Aphyosemion_louessense	False	True
Aphyosemion_ogoense	False	True
Aphyosemion_primigenium	False	True
Aphyosemion_exigoideum	False	True
Aphyosemion_elberti	False	True
Nothobranchius_orthonotus	False	True
Fundulopanchax_mirabilis	False	True
Pachypanchax_omalonotus	False	True
Pachypanchax_sakaramyi	False	True
Pachypanchax_playfairii	False	True
Aplocheilus_lineatus	False	True
Belone_belone	False	True
Oryzias_latipes	False	True
Atherina_presbyter	False	True
Atherina_hepsetus	False	True
Atherina_boyeri	False	True
Atherina_breviceps	False	True
Iso_natalensis	True	False
Bedotia_geayi	False	True
Melanotaenia_lacustris	False	True
Menidia_menidia	False	True
Limnochromis_staneri	False	True
Gnathochromis_permaxillaris	False	True
Baileychromis_centropomoides	False	True
Limnochromis_abeelei	False	True
Greenwoodochromis_bellcrossi	False	True
Cyphotilapia_frontosa	False	True
Plecodus_straeleni	False	True
Perissodus_microlepis	False	True
Plecodus_multidentatus	False	True
Haplotaxodon_trifasciatus	False	True
Haplotaxodon_microlepis	False	True
Plecodus_paradoxus	False	True
Plecodus_elaviae	False	True
Xenochromis_hecqui	False	True
Cyprichromis_pavo	False	True
Cyprichromis_zonatus	False	True
Cyprichromis_coloratus	False	True
Cyprichromis_microlepidotus	False	True
Cyprichromis_leptosoma	False	True
Paracyprichromis_brieni	False	True
Paracyprichromis_nigripinnis	False	True
Benthochromis_melanoides	False	True
Benthochromis_horii	False	True
Benthochromis_tricoti	False	True
Dimidiochromis_compressiceps	False	True
Copadichromis_borleyi	False	True
Lethrinops_parvidens	False	True
Protomelas_similis	False	True
Nimbochromis_fuscotaeniatus	False	True
Labidochromis_caeruleus	False	True
Otopharynx_brooksi	False	True
Otopharynx_heterodon	False	True
Cynotilapia_afra	False	True
Labeotropheus_trewavasae	False	True
Labeotropheus_fuelleborni	False	True
Aulonocara_baenschi	False	True
Melanochromis_auratus	False	True
Melanochromis_vermivorus	False	True
Maylandia_zebra	False	True
Aulonocara_stuartgranti	False	True
Placidochromis_milomo	False	True
Sciaenochromis_fryeri	False	True
Pallidochromis_tokolosh	False	True
Diplotaxodon_macrops	False	True
Rhamphochromis_esox	False	True
Rhamphochromis_longiceps	False	True
Astatotilapia_calliptera	False	True
Haplochromis_nyererei	False	True
Haplochromis_pyrrhocephalus	False	True
Haplochromis_fischeri	False	True
Haplochromis_riponianus	False	True
Haplochromis_degeni	False	True
Astatotilapia_burtoni	False	True
Cyathopharynx_furcifer	False	True
Ophthalmotilapia_ventralis	False	True
Ophthalmotilapia_nasuta	False	True
Callochromis_macrops	False	True
Grammatotria_lemairii	False	True
Xenotilapia_caudafasciata	False	True
Xenotilapia_nigrolabiata	False	True
Xenotilapia_boulengeri	False	True
Xenotilapia_sima	False	True
Xenotilapia_ochrogenys	False	True
Xenotilapia_flavipinnis	False	True
Julidochromis_dickfeldi	False	True
Chalinochromis_brichardi	False	True
Julidochromis_ornatus	False	True
Julidochromis_marlieri	False	True
Telmatochromis_temporalis	False	True
Neolamprologus_brichardi	False	True
Telmatochromis_dhonti	False	True
Lamprologus_callipterus	False	True
Neolamprologus_tetracanthus	False	True
Neolamprologus_buescheri	False	True
Neolamprologus_obscurus	False	True
Neolamprologus_leleupi	False	True
Lepidiolamprologus_elongatus	False	True
Lepidiolamprologus_attenuatus	False	True
Lepidiolamprologus_profundicola	False	True
Neolamprologus_variostigma	False	True
Lepidiolamprologus_mimicus	False	True
Lepidiolamprologus_kendalli	False	True
Altolamprologus_calvus	False	True
Altolamprologus_compressiceps	False	True
Neolamprologus_fasciatus	False	True
Lamprologus_lemairii	False	True
Lamprologus_ocellatus	False	True
Neolamprologus_ventralis	False	True
Variabilichromis_moorii	False	True
Neolamprologus_sexfasciatus	False	True
Julidochromis_regani	False	True
Neolamprologus_mondabu	False	True
Neolamprologus_furcifer	False	True
Neolamprologus_tretocephalus	False	True
Spathodus_erythrodon	False	True
Hemibates_stenosoma	False	True
Bathybates_fasciatus	False	True
Trematocara_macrostoma	False	True
Trematocara_unimaculatum	False	True
Boulengerochromis_microlepis	False	True
Coptodon_rendalli	False	True
Coptodon_snyderae	False	True
Coptodon_bemini	False	True
Coptodon_bakossiorum	False	True
Steatocranus_casuarius	False	True
Oreochromis_niloticus	False	True
Sarotherodon_galilaeus	False	True
Sarotherodon_caroli	False	True
Sarotherodon_linnellii	False	True
Sarotherodon_steinbachi	False	True
Sarotherodon_lohbergeri	False	True
Stomatepia_mariae	False	True
Stomatepia_pindu	False	True
Stomatepia_mongo	False	True
Myaka_myaka	False	True
Konia_eisentrauti	False	True
Konia_dikume	False	True
Pungu_maclareni	False	True
Sarotherodon_melanotheron	False	True
Crenicichla_frenata	False	True
Astronotus_ocellatus	False	True
Andinoacara_stalsbergi	False	True
Andinoacara_rivulatus	False	True
Andinoacara_biseriatus	False	True
Andinoacara_latifrons	False	True
Andinoacara_coeruleopunctatus	False	True
Andinoacara_pulcher	False	True
Tahuantinsuyoa_macantzatza	False	True
Emblemaria_diphyodontis	True	False
Emblemaria_pandionis	True	False
Emblemaria_piratica	True	False
Emblemaria_hypacanthus	True	False
Emblemaria_nivipes	True	False
Chaenopsis_alepidota	True	False
Chaenopsis_schmitti	True	False
Lucayablennius_zingaro	True	False
Chaenopsis_limbaughi	True	False
Ekemblemaria_myersi	True	False
Ekemblemaria_nigra	True	False
Hemiemblemaria_simulus	True	False
Protemblemaria_bicirrus	True	False
Cirriemblemaria_lucasana	True	False
Emblemariopsis_signifer	True	False
Emblemariopsis_randalli	True	False
Acanthemblemaria_macrospilus	True	False
Acanthemblemaria_hancocki	True	False
Acanthemblemaria_crockeri	True	False
Acanthemblemaria_rivasi	True	False
Acanthemblemaria_castroi	True	False
Acanthemblemaria_chaplini	True	False
Acanthemblemaria_greenfieldi	True	False
Acanthemblemaria_aspera	True	False
Acanthemblemaria_betinensis	True	False
Acanthemblemaria_exilispinus	True	False
Coralliozetus_angelicus	True	False
Coralliozetus_micropes	True	False
Coralliozetus_boehlkei	True	False
Coralliozetus_cardonae	True	False
Coralliozetus_springeri	True	False
Platygillellus_rubrocinctus	True	False
Gillellus_uranidea	True	False
Dactyloscopus_lacteus	True	False
Paraclinus_mexicanus	True	False
Paraclinus_sini	True	False
Paraclinus_marmoratus	True	False
Paraclinus_integripinnis	True	False
Stathmonotus_culebrai	True	False
Stathmonotus_lugubris	True	False
Stathmonotus_stahli	True	False
Starksia_nanodes	True	False
Starksia_lepicoelia	True	False
Starksia_fasciata	True	False
Starksia_atlantica	True	False
Starksia_galapagensis	True	False
Starksia_posthon	True	False
Xenomedea_rhodopyga	True	False
Starksia_spinipenis	True	False
Starksia_grammilaga	True	False
Starksia_ocellata	True	False
Malacoctenus_zacae	True	False
Malacoctenus_hubbsi	True	False
Malacoctenus_gigas	True	False
Malacoctenus_zonogaster	True	False
Malacoctenus_zonifer	True	False
Malacoctenus_ebisui	True	False
Malacoctenus_tetranemus	True	False
Malacoctenus_triangulatus	True	False
Malacoctenus_aurolineatus	True	False
Malacoctenus_boehlkei	True	False
Labrisomus_nuchipinnis	True	False
Labrisomus_xanti	True	False
Labrisomus_nigricinctus	True	False
Labrisomus_haitiensis	True	False
Dialommus_macrocephalus	True	False
Mccoskerichthys_sandae	True	False
Neoclinus_blanchardi	True	False
Auchenionchus_microcirrhis	True	False
Alloclinus_holderi	True	False
Clinus_spatulatus	True	False
Clinus_superciliosus	True	False
Clinus_musaicus	True	False
Clinus_arborescens	True	False
Clinus_venustris	True	False
Pavoclinus_profundus	True	False
Blennophis_striatus	True	False
Blennioclinus_stella	True	False
Pavoclinus_graminis	True	False
Clinus_cottoides	True	False
Clinus_acuminatus	True	False
Cancelloxus_longior	True	False
Muraenoclinus_dorsalis	True	False
Clinus_agilis	True	False
Heteroclinus_adelaidae	True	False
Cristiceps_australis	True	False
Gibbonsia_metzi	True	False
Gibbonsia_montereyensis	True	False
Gibbonsia_elegans	True	False
Heterostichus_rostratus	True	False
Calliclinus_geniguttatus	True	False
Petroscirtes_mitratus	True	False
Meiacanthus_oualanensis	True	False
Plagiotremus_azaleus	True	False
Plagiotremus_tapeinosoma	True	False
Plagiotremus_rhinorhynchos	True	False
Omobranchus_anolius	False	True
Omobranchus_obliquus	False	True
Hypleurochilus_fissicornis	True	False
Hypleurochilus_aequipinnis	True	False
Parablennius_intermedius	False	True
Parablennius_cornutus	True	False
Parablennius_tasmanianus	False	True
Parablennius_yatabei	True	False
Parablennius_tentacularis	False	True
Parablennius_rouxi	True	False
Parablennius_marmoreus	True	False
Parablennius_pilicornis	True	False
Parablennius_zvonimiri	False	True
Scartella_caboverdiana	True	False
Scartella_emarginata	True	False
Scartella_cristata	True	False
Hypsoblennius_caulopus	True	False
Hypsoblennius_gentilis	False	True
Hypsoblennius_jenkinsi	True	False
Hypsoblennius_hentz	True	False
Hypsoblennius_gilberti	True	False
Hypsoblennius_brevipinnis	True	False
Salaria_fluviatilis	False	True
Parablennius_sanguinolentus	True	False
Parablennius_parvicornis	True	False
Salaria_pavo	False	True
Parablennius_gattorugine	True	False
Microlipophrys_caboverdensis	True	False
Microlipophrys_velifer	True	False
Microlipophrys_dalmatinus	True	False
Microlipophrys_bauchotae	True	False
Microlipophrys_canevae	True	False
Lipophrys_pholis	True	False
Lipophrys_trigloides	False	True
Coryphoblennius_galerita	False	True
Blenniella_chrysospilos	True	False
Blenniella_cyanostigma	True	False
Istiblennius_dussumieri	False	True
Istiblennius_lineatus	True	False
Istiblennius_edentulus	True	False
Entomacrodus_nigricans	True	False
Entomacrodus_striatus	True	False
Entomacrodus_chiostictus	True	False
Entomacrodus_niuafoouensis	True	False
Praealticus_striatus	True	False
Praealticus_tanegasimae	True	False
Praealticus_margaritatus	True	False
Praealticus_labrovittatus	True	False
Alticus_saliens	True	False
Andamia_reyi	True	False
Andamia_tetradactylus	True	False
Praealticus_caesius	True	False
Rhabdoblennius_nitidus	True	False
Nannosalarias_nativitatis	True	False
Salarias_alboguttatus	True	False
Salarias_fasciatus	True	False
Cirripectes_castaneus	True	False
Cirripectes_filamentosus	True	False
Cirripectes_stigmaticus	True	False
Cirripectes_quagga	True	False
Ophioblennius_steindachneri	True	False
Ophioblennius_macclurei	True	False
Ecsenius_opsifrontalis	True	False
Ecsenius_pardus	True	False
Ecsenius_nalolo	True	False
Ecsenius_midas	True	False
Cremnochorites_capensis	True	False
Helcogramma_ellioti	True	False
Helcogramma_fuscopinna	True	False
Enneapterygius_abeli	True	False
Enneapterygius_gruschkai	True	False
Enneapterygius_tutuilae	True	False
Ruanoho_whero	True	False
Tripterygion_delaisi	True	False
Forsterygion_lapillum	True	False
Axoclinus_storeyae	True	False
Axoclinus_lucillae	True	False
Axoclinus_nigricaudus	True	False
Enneanectes_boehlkei	True	False
Enneanectes_altivelis	True	False
Enneanectes_carminalis	True	False
Lepidonectes_corallicola	True	False
Lepadogaster_lepadogaster	True	False
Apletodon_dentatus	False	True
Gobiesox_pinniger	True	False
Gobiesox_juradoensis	False	True
Gobiesox_rhessodon	True	False
Tomicodon_myersi	True	False
Tomicodon_humeralis	True	False
Aspasma_minima	True	False
Embiotoca_jacksoni	True	False
Chromis_limbata	True	False
Chromis_viridis	True	False
Dascyllus_trimaculatus	True	False
Dascyllus_aruanus	True	False
Amphiprion_akindynos	True	False
Amphiprion_melanopus	True	False
Neopomacentrus_bankieri	True	False
Pomacentrus_amboinensis	True	False
Pomacentrus_pavo	True	False
Chrysiptera_rex	True	False
Chrysiptera_cyanea	True	False
Abudefduf_sexfasciatus	True	False
Parma_oligolepis	True	False
Stegastes_gascoynei	True	False
Plectroglyphidodon_dickii	True	False
Liza_aurata	False	True
Chelon_labrosus	False	True
Moolgarda_cunnesius	False	True
Mugil_cephalus	False	True
Parambassis_ranga	False	True
Parambassis_wolffii	False	True
Samariscus_latus	True	False
Samaris_cristatus	True	False
Trinectes_maculatus	False	True
Microchirus_azevia	True	False
Microchirus_variegatus	True	False
Dicologlossa_cuneata	False	True
Solea_aegyptiaca	False	True
Solea_senegalensis	True	False
Solea_solea	False	True
Synapturichthys_kleinii	False	True
Pegusa_cadenati	True	False
Pegusa_lascaris	False	True
Buglossidium_luteum	False	True
Paraplagusia_japonica	True	False
Cynoglossus_senegalensis	False	True
Cynoglossus_browni	True	False
Arnoglossus_imperialis	True	False
Arnoglossus_laterna	True	False
Bothus_podas	True	False
Chascanopsetta_lugubris	True	False
Syacium_micrurum	True	False
Poecilopsetta_beanii	True	False
Poecilopsetta_plinthus	True	False
Symphurus_orientalis	True	False
Mancopsetta_maculata	True	False
Pseudorhombus_oligodon	True	False
Xystreurys_liolepis	True	False
Paralichthys_olivaceus	False	True
Paralichthys_dentatus	True	False
Limanda_limanda	True	False
Hippoglossoides_platessoides	True	False
Platichthys_flesus	False	True
Pleuronectes_platessa	False	True
Hippoglossus_hippoglossus	True	False
Hippoglossus_stenolepis	True	False
Eopsetta_jordani	True	False
Microstomus_kitt	True	False
Glyptocephalus_cynoglossus	True	False
Lepidorhombus_whiffiagonis	True	False
Lepidorhombus_boscii	True	False
Zeugopterus_punctatus	True	False
Scophthalmus_rhombus	True	False
Scophthalmus_maximus	False	True
Citharus_linguatula	True	False
Citharoides_macrolepis	True	False
Lepidoblepharon_ophthalmolepis	True	False
Brachypleura_novaezeelandiae	True	False
Lactarius_lactarius	False	True
Sphyraena_viridensis	True	False
Sphyraena_argentea	True	False
Sphyraena_barracuda	False	True
Sphyraena_guachancho	True	False
Caranx_crysos	False	True
Gnathanodon_speciosus	True	False
Chloroscombrus_chrysurus	False	True
Selene_dorsalis	False	True
Parastromateus_niger	False	True
Trachurus_mediterraneus	False	True
Trachurus_picturatus	True	False
Trachurus_murphyi	True	False
Trachurus_trachurus	False	True
Selar_crumenophthalmus	True	False
Pseudocaranx_dentex	False	True
Seriola_carpenteri	True	False
Seriola_rivoliana	True	False
Seriola_fasciata	True	False
Seriola_dumerili	True	False
Trachinotus_ovatus	False	True
Lichia_amia	False	True
Coryphaena_equiselis	True	False
Coryphaena_hippurus	True	False
Rachycentron_canadum	True	False
Istiophorus_platypterus	True	False
Makaira_nigricans	True	False
Istiompax_indica	True	False
Kajikia_albida	True	False
Kajikia_audax	True	False
Tetrapturus_georgii	True	False
Tetrapturus_pfluegeri	True	False
Tetrapturus_belone	True	False
Tetrapturus_angustirostris	True	False
Xiphias_gladius	True	False
Mene_maculata	True	False
Toxotes_jaculatrix	False	True
Toxotes_chatareus	False	True
Lates_niloticus	False	True
Lates_calcarifer	False	True
Eleutheronema_rhadinum	True	False
Pentanemus_quinquarius	False	True
Polydactylus_sextarius	False	True
Indostomus_paradoxus	False	True
Monopterus_albus	False	True
Mastacembelus_erythrotaenia	False	True
Channa_striata	False	True
Trimma_caesiura	True	False
Trimma_flammeum	True	False
Lythrypnus_zebra	True	False
Lythrypnus_dalli	True	False
Priolepis_eugenius	True	False
Priolepis_hipoliti	True	False
Priolepis_cincta	False	True
Babka_gymnotrachelus	False	True
Ponticola_cephalargoides	False	True
Mesogobius_batrachocephalus	False	True
Proterorhinus_semilunaris	False	True
Benthophilus_magistri	False	True
Gobius_niger	False	True
Caffrogobius_saldanha	False	True
Elacatinus_oceanops	True	False
Elacatinus_evelynae	True	False
Elacatinus_atronasus	True	False
Elacatinus_genie	True	False
Elacatinus_prochilos	True	False
Elacatinus_illecebrosus	True	False
Elacatinus_figaro	True	False
Elacatinus_randalli	True	False
Elacatinus_chancei	True	False
Elacatinus_lori	True	False
Elacatinus_horsti	True	False
Elacatinus_louisae	True	False
Elacatinus_xanthiprora	True	False
Microgobius_microlepis	False	True
Ophiogobius_jenynsi	False	True
Elacatinus_puncticulatus	True	False
Tigrigobius_gemmatus	True	False
Risor_ruber	True	False
Tigrigobius_saucrus	True	False
Tigrigobius_macrodon	True	False
Elacatinus_limbaughi	True	False
Tigrigobius_nesiotes	True	False
Tigrigobius_janssi	True	False
Ginsburgellus_novemlineatus	False	True
Tigrigobius_multifasciatus	True	False
Barbulifer_ceuthoecus	True	False
Aruma_histrio	True	False
Gobiosoma_chiquita	False	True
Gobiosoma_bosc	False	True
Nes_longus	True	False
Signigobius_biocellatus	True	False
Amblygobius_nocturnus	True	False
Istigobius_rigilius	True	False
Istigobius_decoratus	True	False
Exyrias_belissimus	True	False
Oplopomus_oplopomus	True	False
Arenigobius_bifrenatus	False	True
Cabillus_tongarevae	True	False
Acentrogobius_pflaumii	False	True
Afurcagobius_tamarensis	False	True
Favonigobius_exquisitus	False	True
Favonigobius_melanobranchus	True	False
Favonigobius_reichei	False	True
Cryptocentrus_inexplicatus	True	False
Cryptocentrus_cinctus	True	False
Cryptocentrus_leptocephalus	True	False
Cryptocentrus_lutheri	True	False
Cryptocentrus_albidorsus	True	False
Cryptocentrus_nigrocellatus	True	False
Mahidolia_mystacina	False	True
Valenciennea_strigata	True	False
Valenciennea_longipinnis	True	False
Valenciennea_puellaris	True	False
Amblygobius_phalaena	True	False
Pomatoschistus_minutus	False	True
Pomatoschistus_lozanoi	False	True
Pomatoschistus_pictus	True	False
Pomatoschistus_microps	False	True
Knipowitschia_milleri	False	True
Economidichthys_pygmaeus	False	True
Coryphopterus_punctipectophorus	True	False
Coryphopterus_dicrus	True	False
Coryphopterus_personatus	True	False
Coryphopterus_hyalinus	False	True
Rhinogobiops_nicholsii	True	False
Lophogobius_cyprinoides	False	True
Fusigobius_duospilus	True	False
Fusigobius_signipinnis	True	False
Fusigobius_neophytus	True	False
Ctenogobiops_formosa	True	False
Ctenogobiops_tangaroai	True	False
Ctenogobiops_mitodes	True	False
Ctenogobiops_tongaensis	True	False
Ctenogobiops_aurocingulus	True	False
Vanderhorstia_ornatissima	True	False
Tomiyamichthys_lanceolatus	True	False
Amblyeleotris_fasciata	True	False
Amblyeleotris_yanoi	True	False
Amblyeleotris_wheeleri	True	False
Amblyeleotris_steinitzi	True	False
Amblyeleotris_guttata	True	False
Amblyeleotris_periophthalma	True	False
Amblyeleotris_randalli	True	False
Amblyeleotris_gymnocephala	False	True
Callogobius_bifasciatus	True	False
Stonogobiops_xanthorhinica	True	False
Asterropteryx_ensifera	False	True
Asterropteryx_semipunctata	True	False
Bathygobius_cocosensis	True	False
Bathygobius_soporator	False	True
Bathygobius_curacao	True	False
Psammogobius_biocellatus	False	True
Kraemeria_bryani	True	False
Kraemeria_cunicularia	False	True
Eviota_afelei	True	False
Gobiodon_histrio	True	False
Gobiodon_quinquestrigatus	True	False
Paragobiodon_modestus	True	False
Bryaninops_yongei	True	False
Ptereleotris_monoptera	True	False
Ptereleotris_microlepis	True	False
Ptereleotris_zebra	True	False
Nemateleotris_magnifica	True	False
Microdesmus_bahianus	True	False
Microdesmus_longipinnis	True	False
Microdesmus_carri	False	True
Cerdale_floridana	False	True
Gunnellichthys_monostigma	True	False
Trimmatom_eviotops	True	False
Callogobius_sclateri	True	False
Akihito_futuna	False	True
Akihito_vanuatu	False	True
Sicyopus_zosterophorus	False	True
Lentipes_kaaea	False	True
Lentipes_armatus	False	True
Smilosicyopus_chloe	False	True
Smilosicyopus_sasali	False	True
Stiphodon_rutilaureus	False	True
Stiphodon_rubromaculatus	False	True
Stiphodon_hydoreibatus	False	True
Stiphodon_sapphirinus	False	True
Stiphodon_atratus	False	True
Stiphodon_elegans	False	True
Sicyopterus_lagocephalus	False	True
Sicyopterus_pugnans	False	True
Sicydium_plumieri	False	True
Sicydium_punctatum	False	True
Cotylopus_acutipinnis	False	True
Cotylopus_rubripinnis	False	True
Awaous_guamensis	False	True
Gnatholepis_cauerensis	False	True
Periophthalmus_barbarus	False	True
Ophiocara_porocephala	False	True
Rhyacichthys_guilberti	False	True
Protogobius_attiti	False	True
Sphaeramia_nematoptera	True	False
Ostorhinchus_fasciatus	True	False
Hippocampus_patagonicus	True	False
Hippocampus_erectus	True	False
Hippocampus_hippocampus	False	True
Hippocampus_guttulatus	False	True
Hippocampus_zosterae	True	False
Hippocampus_ingens	True	False
Hippocampus_reidi	True	False
Hippocampus_breviceps	False	True
Hippocampus_bargibanti	True	False
Idiotropiscis_lumnitzeri	True	False
Vanacampus_margaritifer	True	False
Hippichthys_penicillus	False	True
Syngnathus_typhle	False	True
Nerophis_lumbriciformis	True	False
Syngnathus_acus	False	True
Stigmatopora_nigra	False	True
Aeoliscus_strigatus	True	False
Aulostomus_chinensis	True	False
Champsodon_snyderi	True	False
Mullus_surmuletus	False	True
Callionymus_reticulatus	False	True
Callionymus_maculatus	True	False
Callionymus_lyra	True	False
Callionymus_schaapii	True	False
Callionymus_filamentosus	True	False
Fistularia_petimba	True	False
Dactylopterus_volitans	True	False
Dactyloptena_orientalis	True	False
Cubiceps_gracilis	True	False
Pampus_argenteus	True	False
Brama_brama	True	False
Pterycombus_brama	True	False
Taractichthys_longipinnis	True	False
Gasterochisma_melampus	True	False
Scomberomorus_cavalla	True	False
Scomberomorus_maculatus	True	False
Scomberomorus_regalis	True	False
Scomberomorus_brasiliensis	True	False
Scomberomorus_commerson	True	False
Scomber_colias	False	True
Scomber_japonicus	True	False
Scomber_scombrus	True	False
Thunnus_atlanticus	True	False
Thunnus_alalunga	True	False
Thunnus_orientalis	True	False
Thunnus_thynnus	True	False
Thunnus_albacares	True	False
Thunnus_obesus	True	False
Katsuwonus_pelamis	True	False
Euthynnus_alletteratus	False	True
Sarda_sarda	False	True
Acanthocybium_solandri	True	False
Trichiurus_lepturus	False	True
Lepidopus_caudatus	True	False
Aphanopus_carbo	True	False
Paradiplospinus_antarcticus	True	False
Gempylus_serpens	True	False
Ruvettus_pretiosus	True	False
Centrolophus_niger	True	False
Schedophilus_ovalis	True	False
Schedophilus_velaini	True	False
Schedophilus_medusophagus	True	False
Seriolella_brama	True	False
Psenopsis_anomala	True	False
Arripis_trutta	False	True
Pomatomus_saltatrix	False	True
Kali_macrura	True	False
Myoxocephalus_scorpius	False	True
Myoxocephalus_quadricornis	False	True
Taurulus_bubalis	False	True
Cottunculus_thomsonii	True	False
Leocottus_kesslerii	False	True
Xeneretmus_latifrons	True	False
Liparis_fabricii	True	False
Liparis_montagui	True	False
Cyclopterus_lumpus	True	False
Lycodes_terraenovae	True	False
Lycodapus_antarcticus	True	False
Zoarces_viviparus	False	True
Anarhichas_lupus	True	False
Anarhichas_minor	True	False
Pholis_gunnellus	True	False
Spinachia_spinachia	False	True
Gasterosteus_aculeatus	False	True
Eutrigla_gurnardus	False	True
Chelidonichthys_cuculus	False	True
Chelidonichthys_obscurus	True	False
Chelidonichthys_kumu	False	True
Chelidonichthys_lucerna	False	True
Lepidotrigla_cavillone	False	True
Trigla_lyra	False	True
Sebastes_constellatus	True	False
Sebastes_umbrosus	True	False
Sebastes_chlorostictus	True	False
Sebastes_nigrocinctus	True	False
Sebastes_rubrivinctus	True	False
Sebastes_hopkinsi	True	False
Sebastes_ovalis	True	False
Sebastes_melanops	True	False
Sebastes_serranoides	True	False
Sebastes_flavidus	True	False
Sebastes_mystinus	True	False
Sebastes_entomelas	True	False
Sebastes_paucispinis	True	False
Sebastes_miniatus	True	False
Sebastes_pinniger	True	False
Sebastes_nebulosus	True	False
Sebastes_auriculatus	True	False
Sebastes_chrysomelas	True	False
Sebastes_carnatus	True	False
Sebastes_caurinus	True	False
Sebastes_maliger	True	False
Sebastes_semicinctus	True	False
Sebastes_elongatus	True	False
Sebastes_diploproa	True	False
Sebastes_aurora	True	False
Sebastes_melanostomus	True	False
Sebastes_ruberrimus	True	False
Sebastes_alutus	True	False
Sebastes_viviparus	True	False
Sebastes_ciliatus	True	False
Sebastes_proriger	True	False
Sebastes_brevispinis	True	False
Helicolenus_dactylopterus	True	False
Sebastolobus_altivelis	True	False
Pontinus_kuhlii	True	False
Pontinus_longispinis	True	False
Dendrochirus_biocellatus	True	False
Pterois_antennata	True	False
Scorpaenodes_minor	True	False
Scorpaenodes_guamensis	False	True
Scorpaena_elongata	True	False
Scorpaena_scrofa	False	True
Scorpaenopsis_possi	True	False
Scorpaena_notata	False	True
Scorpaena_porcus	False	True
Scorpaenopsis_diabolus	True	False
Scorpaena_maderensis	False	True
Scorpaena_onaria	True	False
Scorpaenopsis_macrochir	False	True
Caracanthus_unipinna	True	False
Neomerinthe_hemingwayi	True	False
Synanceia_verrucosa	True	False
Onigocia_bimaculata	True	False
Epinephelus_guttatus	True	False
Epinephelus_tauvina	True	False
Epinephelus_aeneus	False	True
Mycteroperca_fusca	True	False
Epinephelus_marginatus	True	False
Epinephelus_costae	True	False
Mycteroperca_rubra	True	False
Cephalopholis_sonnerati	True	False
Belonoperca_chabanaudi	True	False
Rypticus_saponaceus	True	False
Grammistops_ocellatus	True	False
Aporops_bilinearis	True	False
Liopropoma_lunulatum	True	False
Serranus_cabrilla	True	False
Serranus_atricauda	True	False
Serranus_scriba	False	True
Serranus_hepatus	True	False
Serranus_accraensis	True	False
Odontanthias_chrysostictus	True	False
Cryodraco_atkinsoni	True	False
Cryodraco_antarcticus	True	False
Chionobathyscus_dewitti	True	False
Channichthys_rhinoceratus	True	False
Chaenocephalus_aceratus	True	False
Chionodraco_myersi	True	False
Chionodraco_rastrospinosus	True	False
Chionodraco_hamatus	True	False
Chaenodraco_wilsoni	True	False
Pagetopsis_macropterus	True	False
Pagetopsis_maculatus	True	False
Neopagetopsis_ionah	True	False
Pseudochaenichthys_georgianus	True	False
Dacodraco_hunteri	True	False
Champsocephalus_gunnari	True	False
Champsocephalus_esox	True	False
Parachaenichthys_georgianus	True	False
Parachaenichthys_charcoti	True	False
Cygnodraco_mawsoni	True	False
Gerlachea_australis	True	False
Gymnodraco_acuticeps	True	False
Psilodraco_breviceps	True	False
Bathydraco_macrolepis	True	False
Bathydraco_antarcticus	True	False
Bathydraco_marri	True	False
Bathydraco_scotiae	True	False
Akarotaxis_nudiceps	True	False
Racovitzia_glacialis	True	False
Vomeridens_infuscipinnis	True	False
Prionodraco_evansii	True	False
Artedidraco_lonnbergi	True	False
Pogonophryne_scotti	True	False
Dolloidraco_longedorsalis	True	False
Artedidraco_shackletoni	True	False
Histiodraco_velifer	True	False
Artedidraco_orianae	True	False
Artedidraco_skottsbergi	True	False
Harpagifer_antarcticus	True	False
Paranotothenia_magellanica	True	False
Notothenia_angustata	True	False
Notothenia_neglecta	True	False
Notothenia_coriiceps	True	False
Patagonotothen_tessellata	True	False
Patagonotothen_guntheri	True	False
Patagonotothen_ramsayi	True	False
Lepidonotothen_squamifrons	True	False
Trematomus_hansoni	True	False
Trematomus_eulepidotus	True	False
Trematomus_pennellii	True	False
Trematomus_tokarevi	True	False
Trematomus_bernacchii	True	False
Trematomus_loennbergii	True	False
Pagothenia_borchgrevinki	True	False
Trematomus_newnesi	True	False
Gobionotothen_gibberifrons	True	False
Gobionotothen_acuta	True	False
Pleuragramma_antarctica	True	False
Dissostichus_eleginoides	True	False
Dissostichus_mawsoni	True	False
Eleginops_maclovinus	False	True
Pseudaphritis_urvillii	False	True
Cottoperca_gobio	True	False
Bovichtus_variegatus	True	False
Etheostoma_rufilineatum	False	True
Perca_fluviatilis	False	True
Gymnocephalus_cernua	False	True
Niphon_spinosus	True	False
Trachinus_radiatus	True	False
Trachinus_draco	True	False
Echiichthys_vipera	True	False
Synagrops_bellus	True	False
Howella_brodiei	True	False
Epigonus_telescopus	True	False
Polyprion_oxygeneios	True	False
Polyprion_americanus	False	True
Lateolabrax_japonicus	False	True
Stereolepis_gigas	True	False
Lepomis_miniatus	False	True
Lepomis_punctatus	False	True
Lepomis_microlophus	False	True
Lepomis_gibbosus	False	True
Lepomis_marginatus	False	True
Lepomis_megalotis	False	True
Lepomis_auritus	False	True
Lepomis_macrochirus	False	True
Lepomis_humilis	False	True
Lepomis_symmetricus	False	True
Lepomis_cyanellus	False	True
Lepomis_gulosus	False	True
Micropterus_treculii	False	True
Micropterus_punctulatus	False	True
Micropterus_dolomieu	False	True
Micropterus_salmoides	False	True
Micropterus_floridanus	False	True
Micropterus_notius	False	True
Micropterus_coosae	False	True
Micropterus_cataractae	False	True
Ambloplites_constellatus	False	True
Ambloplites_cavifrons	False	True
Ambloplites_rupestris	False	True
Ambloplites_ariommus	False	True
Pomoxis_annularis	False	True
Pomoxis_nigromaculatus	False	True
Archoplites_interruptus	False	True
Enneacanthus_gloriosus	False	True
Enneacanthus_obesus	False	True
Enneacanthus_chaetodon	False	True
Centrarchus_macropterus	False	True
Acantharchus_pomotis	False	True
Elassoma_alabamae	False	True
Elassoma_zonatum	False	True
Elassoma_boehlkei	False	True
Elassoma_evergladei	False	True
Elassoma_gilberti	False	True
Coreoperca_kawamebari	False	True
Bostockia_porosa	False	True
Gadopsis_marmoratus	False	True
Nemadactylus_monodactylus	True	False
Nemadactylus_macropterus	True	False
Latridopsis_ciliaris	True	False
Aplodactylus_punctatus	True	False
Amblycirrhitus_bimacula	True	False
Cirrhitus_pinnulatus	True	False
Paracirrhites_hemistictus	True	False
Paracirrhites_forsteri	True	False
Enoplosus_armatus	True	False
Kuhlia_mugil	False	True
Kuhlia_petiti	True	False
Kuhlia_sandvicensis	False	True
Kuhlia_nutabunda	True	False
Kuhlia_xenura	False	True
Kuhlia_rupestris	False	True
Kuhlia_caudavittata	False	True
Kuhlia_malo	False	True
Kuhlia_salelea	False	True
Kuhlia_marginata	False	True
Kuhlia_sauvagii	False	True
Kuhlia_munda	False	True
Pelates_quadrilineatus	False	True
Girella_punctata	True	False
Microcanthus_strigatus	True	False
Kyphosus_vaigiensis	False	True
Eugerres_plumieri	False	True
Diapterus_auratus	False	True
Gerres_cinereus	False	True
Eucinostomus_gula	False	True
Parapercis_clathrata	True	False
Ammodytes_tobianus	True	False
Hyperoplus_lanceolatus	True	False
Cheimarrichthys_fosteri	False	True
Uranoscopus_scaber	False	True
Uranoscopus_albesca	True	False
Kathetostoma_giganteum	True	False
Dicentrarchus_labrax	False	True
Dicentrarchus_punctatus	False	True
Morone_saxatilis	False	True
Sillago_sihama	False	True
Pomadasys_perotaei	False	True
Pomadasys_incisus	True	False
Haemulon_aurolineatum	True	False
Parapristipoma_octolineatum	True	False
Plectorhinchus_mediterraneus	True	False
Lutjanus_analis	False	True
Lutjanus_sebae	False	True
Pterocaesio_digramma	True	False
Holacanthus_ciliaris	True	False
Pomacanthus_maculosus	True	False
Erythrocles_monodi	True	False
Chaetodon_semilarvatus	True	False
Aurigequula_fasciata	False	True
Lethrinus_olivaceus	True	False
Gnathodentex_aureolineatus	True	False
Monotaxis_grandoculis	True	False
Dentex_angolensis	True	False
Dentex_maroccanus	True	False
Dentex_macrophthalmus	True	False
Dentex_gibbosus	False	True
Dentex_canariensis	True	False
Dentex_dentex	False	True
Pagrus_caeruleostictus	False	True
Pagrus_auriga	True	False
Pagellus_erythrinus	False	True
Pagellus_bellottii	True	False
Pagrus_pagrus	False	True
Chrysophrys_auratus	False	True
Sparus_aurata	False	True
Chrysophrys_major	True	False
Diplodus_puntazzo	False	True
Diplodus_sargus_cadenati	False	True
Diplodus_annularis	False	True
Diplodus_vulgaris	True	False
Acanthopagrus_butcheri	False	True
Acanthopagrus_berda	False	True
Pagellus_acarne	True	False
Pagellus_bogaraveo	False	True
Lithognathus_mormyrus	False	True
Boops_boops	False	True
Sarpa_salpa	True	False
Oblada_melanura	False	True
Spicara_maena	True	False
Spicara_smaris	False	True
Spondyliosoma_cantharus	False	True
Lopholatilus_chamaeleonticeps	True	False
Pseudotolithus_senegalensis	False	True
Pseudotolithus_typus	False	True
Pseudotolithus_elongatus	False	True
Pseudotolithus_senegallus	False	True
Argyrosomus_regius	False	True
Umbrina_canariensis	True	False
Cynoscion_regalis	False	True
Atractoscion_aequidens	False	True
Menticirrhus_americanus	False	True
Capros_aper	True	False
Siganus_vulpinus	True	False
Antigonia_capros	True	False
Selenotoca_multifasciata	False	True
Scatophagus_argus	False	True
Priacanthus_hamrur	True	False
Priacanthus_arenatus	True	False
Heteropriacanthus_cruentatus	True	False
Acanthurus_mata	True	False
Acanthurus_blochii	True	False
Acanthurus_xanthopterus	True	False
Acanthurus_bariene	True	False
Acanthurus_leucocheilus	True	False
Acanthurus_auranticavus	True	False
Acanthurus_nigricauda	True	False
Acanthurus_tennentii	True	False
Acanthurus_olivaceus	True	False
Acanthurus_bahianus	True	False
Acanthurus_chirurgus	True	False
Acanthurus_monroviae	True	False
Ctenochaetus_strigosus	True	False
Ctenochaetus_truncatus	True	False
Ctenochaetus_binotatus	True	False
Acanthurus_pyroferus	True	False
Ctenochaetus_striatus	True	False
Acanthurus_thompsoni	True	False
Acanthurus_japonicus	True	False
Acanthurus_nigricans	True	False
Acanthurus_achilles	True	False
Acanthurus_leucosternon	True	False
Acanthurus_coeruleus	True	False
Acanthurus_guttatus	True	False
Acanthurus_lineatus	True	False
Acanthurus_nigrofuscus	True	False
Acanthurus_triostegus	True	False
Zebrasoma_velifer	True	False
Zebrasoma_desjardinii	True	False
Zebrasoma_scopas	True	False
Zebrasoma_flavescens	True	False
Paracanthurus_hepatus	True	False
Prionurus_biafraensis	True	False
Prionurus_laticlavius	True	False
Prionurus_maculatus	True	False
Naso_lituratus	True	False
Naso_elegans	True	False
Naso_unicornis	True	False
Naso_vlamingii	True	False
Naso_brevirostris	True	False
Takifugu_porphyreus	False	True
Takifugu_rubripes	False	True
Takifugu_pardalis	True	False
Takifugu_xanthopterus	False	True
Takifugu_stictonotus	True	False
Takifugu_niphobles	True	False
Takifugu_ocellatus	False	True
Torquigener_altipinnis	False	True
Torquigener_hypselogeneion	False	True
Torquigener_flavimaculosus	True	False
Polyspina_piosae	True	False
Torquigener_squamicauda	False	True
Torquigener_pleurogramma	False	True
Tetractenos_hamiltoni	True	False
Tetractenos_glaber	False	True
Reicheltia_halsteadi	True	False
Marilyna_darwinii	False	True
Sphoeroides_pachygaster	True	False
Sphoeroides_lobatus	False	True
Sphoeroides_maculatus	False	True
Sphoeroides_nephelus	False	True
Sphoeroides_parvus	False	True
Sphoeroides_dorsalis	True	False
Sphoeroides_spengleri	False	True
Sphoeroides_testudineus	False	True
Sphoeroides_annulatus	False	True
Sphoeroides_lispus	True	False
Colomesus_asellus	False	True
Carinotetraodon_salivator	False	True
Carinotetraodon_irrubesco	False	True
Carinotetraodon_travancoricus	False	True
Auriglobus_nefastus	False	True
Chonerhinos_naritus	False	True
Tetraodon_palembangensis	False	True
Tetraodon_suvattii	False	True
Arothron_immaculatus	False	True
Arothron_manilensis	False	True
Arothron_mappa	True	False
Arothron_stellatus	True	False
Arothron_hispidus	False	True
Arothron_nigropunctatus	True	False
Arothron_meleagris	True	False
Arothron_diadematus	True	False
Omegophora_armilla	True	False
Tetraodon_mbu	False	True
Tetraodon_duboisi	False	True
Tetraodon_miurus	False	True
Tetraodon_lineatus	False	True
Tetraodon_pustulatus	False	True
Canthigaster_papua	True	False
Canthigaster_compressa	False	True
Canthigaster_solandri	True	False
Canthigaster_punctatissima	True	False
Canthigaster_jactator	True	False
Canthigaster_janthinoptera	True	False
Canthigaster_leoparda	True	False
Canthigaster_valentini	True	False
Canthigaster_coronata	True	False
Canthigaster_rostrata	True	False
Canthigaster_figueiredoi	True	False
Canthigaster_callisterna	True	False
Canthigaster_smithae	True	False
Canthigaster_rivulata	True	False
Canthigaster_bennetti	True	False
Canthigaster_amboinensis	True	False
Pelagocephalus_marki	True	False
Tetraodon_erythrotaenia	False	True
Lagocephalus_lunaris	False	True
Lagocephalus_laevigatus	False	True
Lagocephalus_guentheri	True	False
Lagocephalus_wheeleri	True	False
Lagocephalus_suezensis	True	False
Diodon_liturosus	True	False
Diodon_hystrix	True	False
Diodon_holocanthus	True	False
Allomycterus_pilatus	True	False
Diodon_nicthemerus	True	False
Chilomycterus_reticulatus	True	False
Chilomycterus_antennatus	True	False
Chilomycterus_schoepfii	True	False
Chilomycterus_antillarum	True	False
Ranzania_laevis	True	False
Mola_mola	False	True
Meuschenia_trachylepis	True	False
Thamnaconus_modestus	False	True
Pseudomonacanthus_macrurus	True	False
Pseudomonacanthus_peroni	True	False
Cantherhines_pardalis	True	False
Cantherhines_pullus	True	False
Aluterus_schoepfii	True	False
Aluterus_heudelotii	True	False
Aluterus_scriptus	True	False
Aluterus_monoceros	True	False
Pervagor_janthinosoma	True	False
Pervagor_melanocephalus	True	False
Pervagor_nigrolineatus	True	False
Stephanolepis_cirrhifer	True	False
Stephanolepis_auratus	True	False
Stephanolepis_hispidus	True	False
Acreichthys_tomentosus	True	False
Monacanthus_chinensis	False	True
Paramonacanthus_choirocephalus	True	False
Chaetodermis_penicilligerus	True	False
Paraluteres_prionurus	True	False
Rudarius_ercodes	True	False
Brachaluteres_jacksonianus	True	False
Oxymonacanthus_longirostris	True	False
Monacanthus_ciliatus	True	False
Rhinecanthus_assasi	True	False
Rhinecanthus_aculeatus	True	False
Rhinecanthus_rectangulus	True	False
Rhinecanthus_lunula	True	False
Rhinecanthus_verrucosus	True	False
Sufflamen_albicaudatum	True	False
Sufflamen_chrysopterum	True	False
Sufflamen_bursa	True	False
Sufflamen_fraenatum	True	False
Sufflamen_verres	True	False
Balistes_capriscus	True	False
Balistes_polylepis	True	False
Balistes_vetula	True	False
Pseudobalistes_fuscus	True	False
Pseudobalistes_naufragium	True	False
Balistes_punctatus	True	False
Canthidermis_maculata	True	False
Xanthichthys_lineopunctatus	True	False
Xanthichthys_mento	True	False
Xanthichthys_auromarginatus	True	False
Xanthichthys_ringens	True	False
Balistoides_viridescens	True	False
Pseudobalistes_flavimarginatus	False	True
Melichthys_vidua	True	False
Melichthys_indicus	True	False
Melichthys_niger	True	False
Balistoides_conspicillum	True	False
Odonus_niger	True	False
Balistapus_undulatus	True	False
Pseudotriacanthus_strigilifer	True	False
Triacanthus_nieuhofii	True	False
Trixiphichthys_weberi	True	False
Tydemania_navigatoris	True	False
Triacanthodes_ethiops	True	False
Parahollardia_lineata	True	False
Lactoria_diaphana	True	False
Lactoria_cornuta	True	False
Tetrosomus_reipublicae	True	False
Tetrosomus_concatenatus	True	False
Tetrosomus_gibbosus	True	False
Ostracion_solorensis	True	False
Ostracion_whitleyi	True	False
Ostracion_cubicus	True	False
Ostracion_meleagris	True	False
Ostracion_rhinorhynchos	True	False
Acanthostracion_polygonius	True	False
Acanthostracion_quadricornis	True	False
Lactophrys_trigonus	True	False
Anoplocapros_inermis	True	False
Anoplocapros_lenticularis	True	False
Aracana_aurita	True	False
Capropygia_unistriata	True	False
Caprichthys_gymnura	True	False
Kentrocapros_rosapinto	True	False
Triodon_macropterus	True	False
Cepola_macrophthalma	True	False
Antennarius_striatus	True	False
Ceratias_holboelli	True	False
Lophius_budegassa	False	True
Lophius_piscatorius	False	True
Glaucosoma_buergeri	True	False
Glaucosoma_scapulare	True	False
Glaucosoma_hebraicum	True	False
Glaucosoma_magnificum	True	False
Pempheris_schwenkii	True	False
Thalassoma_pavo	False	True
Xyrichtys_novacula	True	False
Labrus_mixtus	True	False
Labrus_bergylta	True	False
Acantholabrus_palloni	True	False
Scarus_psittacus	True	False
Sparisoma_rubripinne	True	False
Sparisoma_cretense	True	False
Bodianus_scrofa	True	False
Odax_pullus	True	False
Opsanus_pardus	True	False
Halobatrachus_didactylus	False	True
Lamprogrammus_shcherbachevi	True	False
Neobythites_sivicola	True	False
Echiodon_cryomargarites	True	False
Brotula_barbata	True	False
Lucifuga_subterranea	False	True
Lucifuga_simile	False	True
Lucifuga_dentata	False	True
Cataetyx_laticeps	True	False
Melamphaes_suborbitalis	True	False
Beryx_decadactylus	True	False
Beryx_splendens	True	False
Barbourisia_rufa	True	False
Hoplostethus_atlanticus	True	False
Sargocentron_diadema	True	False
Sargocentron_xantherythrum	True	False
Sargocentron_microstoma	True	False
Sargocentron_punctatissimum	True	False
Neoniphon_sammara	True	False
Neoniphon_argenteus	True	False
Neoniphon_aurolineatus	True	False
Sargocentron_tiere	True	False
Sargocentron_spiniferum	True	False
Myripristis_violacea	True	False
Myripristis_berndti	True	False
Regalecus_glesne	True	False
Lampris_guttatus	True	False
Lampris_immaculatus	True	False
Coryphaenoides_profundicolus	True	False
Coryphaenoides_leptolepis	True	False
Coryphaenoides_carapinus	True	False
Coryphaenoides_rupestris	True	False
Macruronus_novaezelandiae	True	False
Molva_molva	True	False
Molva_dypterygia	False	True
Brosme_brosme	True	False
Trisopterus_esmarkii	True	False
Trisopterus_minutus	True	False
Trisopterus_luscus	False	True
Gadiculus_argenteus	True	False
Micromesistius_poutassou	True	False
Merlangius_merlangus	False	True
Melanogrammus_aeglefinus	True	False
Gadus_ogac	False	True
Gadus_morhua	False	True
Pollachius_virens	True	False
Pollachius_pollachius	True	False
Enchelyopus_cimbrius	True	False
Ciliata_septentrionalis	True	False
Gaidropsarus_mediterraneus	False	True
Phycis_phycis	False	True
Phycis_blennoides	False	True
Merluccius_senegalensis	True	False
Merluccius_merluccius	False	True
Merluccius_capensis	True	False
Merluccius_polli	True	False
Merluccius_paradoxus	True	False
Merluccius_australis	True	False
Merluccius_hubbsi	True	False
Merluccius_productus	True	False
Mora_moro	True	False
Pseudophycis_bachus	True	False
Trachyrincus_murrayi	True	False
Zenopsis_conchifer	True	False
Zeus_faber	True	False
Grammicolepis_brachiusculus	True	False
Neocyttus_helgae	True	False
Chologaster_cornuta	False	True
Forbesichthys_agassizii	False	True
Forbesichthys_papilliferus	False	True
Amblyopsis_spelaea	False	True
Typhlichthys_subterraneus	False	True
Speoplatyrhinus_poulsoni	False	True
Aphredoderus_sayanus	False	True
Percopsis_omiscomaycus	False	True
Percopsis_transmontana	False	True
Polymixia_japonica	True	False
Polymixia_nobilis	True	False
Benthosema_pterotum	True	False
Electrona_antarctica	True	False
Diaphus_metopoclampus	True	False
Diaphus_watasei	True	False
Stenobrachius_leucopsarus	True	False
Aulopus_filamentosus	True	False
Notolepis_coatsi	True	False
Chlorophthalmus_agassizi	True	False
Synodus_foetens	False	True
Synodus_saurus	True	False
Osmerus_eperlanus	False	True
Hypomesus_nipponensis	False	True
Neosalanx_anderssoni	False	True
Protosalanx_chinensis	False	True
Salangichthys_microdon	False	True
Prototroctes_maraena	False	True
Stokellia_anisodon	False	True
Sigmops_bathyphilus	True	False
Bonapartia_pedaliota	True	False
Eustomias_acinosus	True	False
Eustomias_filifer	True	False
Pachystomias_microdon	True	False
Aristostomias_tittmanni	True	False
Aristostomias_scintillans	True	False
Bathophilus_vaillanti	True	False
Bathophilus_pawneei	True	False
Idiacanthus_antrostomus	True	False
Stomias_gracilis	True	False
Astronesthes_macropogon	True	False
Stomias_atriventer	True	False
Chauliodus_macouni	True	False
Chauliodus_sloani	True	False
Polyipnus_asteroides	True	False
Polyipnus_stereope	True	False
Yarrella_blackfordi	True	False
Pollichthys_mauli	True	False
Oncorhynchus_clarkii	False	True
Oncorhynchus_mykiss	False	True
Oncorhynchus_kisutch	False	True
Oncorhynchus_tshawytscha	False	True
Oncorhynchus_gorbuscha	False	True
Oncorhynchus_keta	False	True
Oncorhynchus_nerka	False	True
Salmo_salar	False	True
Salmo_trutta	False	True
Brachymystax_lenok	False	True
Coregonus_autumnalis	False	True
Dallia_pectoralis	False	True
Esox_reichertii	False	True
Esox_lucius	False	True
Umbra_limi	False	True
Umbra_pygmaea	False	True
Argentina_sphyraena	True	False
Argentina_silus	True	False
Argentina_sialis	True	False
Argentina_striata	True	False
Bathylagus_euryops	True	False
Lepidogalaxias_salamandroides	False	True
Rutilus_rutilus	False	True
Abramis_brama	False	True
Telestes_croaticus	False	True
Telestes_fontinalis	False	True
Telestes_metohiensis	False	True
Telestes_souffia	False	True
Phoxinellus_alepidotus	False	True
Phoxinellus_pseudalepidotus	False	True
Phoxinellus_dalmaticus	False	True
Squalius_aradensis	False	True
Squalius_torgalensis	False	True
Squalius_carolitertii	False	True
Squalius_pyrenaicus	False	True
Squalius_cephalus	False	True
Alburnus_alburnus	False	True
Scardinius_erythrophthalmus	False	True
Notemigonus_crysoleucas	False	True
Delminichthys_adspersus	False	True
Delminichthys_ghetaldii	False	True
Delminichthys_jadovensis	False	True
Delminichthys_krbavensis	False	True
Pelasgus_prespensis	False	True
Pelecus_cultratus	False	True
Gila_eremica	False	True
Gila_purpurea	False	True
Gila_seminuda	False	True
Gila_elegans	False	True
Gila_ditaenia	False	True
Gila_nigra	False	True
Moapa_coriacea	False	True
Gila_atraria	False	True
Gila_cypha	False	True
Gila_brevicauda	False	True
Gila_pulchra	False	True
Gila_modesta	False	True
Gila_pandora	False	True
Gila_nigrescens	False	True
Gila_conspersa	False	True
Ptychocheilus_lucius	False	True
Gila_robusta	False	True
Gila_minacae	False	True
Gila_orcuttii	False	True
Acrocheilus_alutaceus	False	True
Ptychocheilus_grandis	False	True
Relictus_solitarius	False	True
Hesperoleucus_symmetricus	False	True
Siphateles_boraxobius	False	True
Siphateles_alvordensis	False	True
Ptychocheilus_umpquae	False	True
Ptychocheilus_oregonensis	False	True
Siphateles_bicolor	False	True
Mylopharodon_conocephalus	False	True
Lavinia_exilicauda	False	True
Orthodon_microlepidotus	False	True
Chrosomus_erythrogaster	False	True
Rhynchocypris_percnurus	False	True
Pseudaspius_leptocephalus	False	True
Tribolodon_nakamurai	False	True
Lepidomeda_vittata	False	True
Lepidomeda_albivallis	False	True
Meda_fulgida	False	True
Plagopterus_argentissimus	False	True
Hemitremia_flammea	False	True
Semotilus_atromaculatus	False	True
Couesius_plumbeus	False	True
Margariscus_margarita	False	True
Algansea_lacustris	False	True
Algansea_tincella	False	True
Algansea_monticola	False	True
Algansea_avia	False	True
Agosia_chrysogaster	False	True
Tampichthys_catostomops	False	True
Tampichthys_mandibularis	False	True
Tampichthys_erimyzonops	False	True
Tampichthys_ipni	False	True
Codoma_ornata	False	True
Cyprinella_garmani	False	True
Cyprinella_lutrensis	False	True
Cyprinella_formosa	False	True
Cyprinella_bocagrande	False	True
Cyprinella_rutila	False	True
Cyprinella_xanthicara	False	True
Cyprinella_proserpina	False	True
Cyprinella_monacha	False	True
Notropis_rubricroceus	False	True
Notropis_chrosomus	False	True
Notropis_chiliticus	False	True
Notropis_chlorocephalus	False	True
Notropis_lutipinnis	False	True
Notropis_blennius	False	True
Notropis_baileyi	False	True
Notropis_petersoni	False	True
Notropis_texanus	False	True
Notropis_longirostris	False	True
Notropis_nubilus	False	True
Hybognathus_placitus	False	True
Hybognathus_nuchalis	False	True
Hybopsis_winchelli	False	True
Notropis_boucardi	False	True
Notropis_moralesi	False	True
Notropis_imeldae	False	True
Yuriria_alta	False	True
Notropis_calientis	False	True
Notropis_leuciodus	False	True
Notropis_volucellus	False	True
Notropis_spectrunculus	False	True
Notropis_rubellus	False	True
Notropis_atherinoides	False	True
Luxilus_chrysocephalus	False	True
Pteronotropis_hypselopterus	False	True
Erimystax_dissimilis	False	True
Phenacobius_catostomus	False	True
Macrhybopsis_aestivalis	False	True
Platygobio_gracilis	False	True
Dionda_melanops	False	True
Dionda_argentosa	False	True
Dionda_nigrotaeniata	False	True
Dionda_episcopa	False	True
Dionda_diaboli	False	True
Dionda_serena	False	True
Nocomis_leptocephalus	False	True
Nocomis_raneyi	False	True
Nocomis_micropogon	False	True
Nocomis_biguttatus	False	True
Nocomis_effusus	False	True
Nocomis_asper	False	True
Campostoma_ornatum	False	True
Campostoma_anomalum	False	True
Campostoma_pauciradii	False	True
Campostoma_oligolepis	False	True
Rhinichthys_cataractae	False	True
Rhinichthys_osculus	False	True
Rhinichthys_atratulus	False	True
Oregonichthys_crameri	False	True
Exoglossum_maxillingua	False	True
Exoglossum_laurae	False	True
Richardsonius_egregius	False	True
Richardsonius_balteatus	False	True
Iotichthys_phlegethontis	False	True
Clinostomus_funduloides	False	True
Mylocheilus_caurinus	False	True
Pogonichthys_macrolepidotus	False	True
Phoxinus_phoxinus	False	True
Tanichthys_albonubes	False	True
Tanichthys_micagemmae	False	True
Tinca_tinca	False	True
Microphysogobio_amurensis	False	True
Biwia_zezera	False	True
Microphysogobio_longidorsalis	False	True
Microphysogobio_elongatus	False	True
Abbottina_rivularis	False	True
Pseudogobio_guilinensis	False	True
Pseudogobio_vaillanti	False	True
Pseudogobio_esocinus	False	True
Saurogobio_dabryi	False	True
Gobiobotia_pappenheimi	False	True
Gobiobotia_meridionalis	False	True
Romanogobio_tenuicorpus	False	True
Gobio_cynocephalus	False	True
Gobio_coriparoides	False	True
Gobio_gobio	False	True
Romanogobio_ciscaucasicus	False	True
Romanogobio_tanaiticus	False	True
Gnathopogon_herzensteini	False	True
Gnathopogon_elongatus	False	True
Coreoleuciscus_splendidus	False	True
Pseudorasbora_pumila	False	True
Pseudorasbora_parva	False	True
Pungtungia_herzi	False	True
Rhinogobio_typus	False	True
Sarcocheilichthys_soldatovi	False	True
Sarcocheilichthys_parvus	False	True
Hemibarbus_maculatus	False	True
Hemibarbus_labeo	False	True
Belligobio_nummifer	False	True
Hemibarbus_mylodon	False	True
Squalidus_wolterstorffi	False	True
Squalidus_argentatus	False	True
Tanakia_himantegus	False	True
Tanakia_limbata	False	True
Acheilognathus_typus	False	True
Hypophthalmichthys_nobilis	False	True
Hypophthalmichthys_molitrix	False	True
Chanodichthys_erythropterus	False	True
Culter_alburnus	False	True
Sinibrama_macrops	False	True
Chanodichthys_mongolicus	False	True
Culter_flavipinnis	False	True
Parabramis_pekinensis	False	True
Megalobrama_amblycephala	False	True
Ischikauia_steenackeri	False	True
Hemiculter_bleekeri	False	True
Hemiculter_lucidus	False	True
Hainania_serrata	False	True
Toxabramis_houdemeri	False	True
Pseudohemiculter_dispar	False	True
Hemiculter_leucisculus	False	True
Pseudolaubuca_engraulis	False	True
Xenocypris_macrolepis	False	True
Plagiognathops_microlepis	False	True
Ochetobius_elongatus	False	True
Mylopharyngodon_piceus	False	True
Ctenopharyngodon_idella	False	True
Elopichthys_bambusa	False	True
Luciobrama_macrocephalus	False	True
Squaliobarbus_curriculus	False	True
Metzia_lineata	False	True
Hemigrammocypris_rasborella	False	True
Metzia_formosae	False	True
Paralaubuca_riveroi	False	True
Paralaubuca_typus	False	True
Paralaubuca_barroni	False	True
Parachela_williaminae	False	True
Parachela_siamensis	False	True
Parachela_oxygastroides	False	True
Parachela_maculicauda	False	True
Oxygaster_anomalura	False	True
Macrochirichthys_macrochirus	False	True
Aphyocypris_chinensis	False	True
Yaoshanicus_arcus	False	True
Opsariichthys_bidens	False	True
Opsariichthys_uncirostris	False	True
Opsariichthys_pachycephalus	False	True
Opsariichthys_evolans	False	True
Zacco_platypus	False	True
Nipponocypris_sieboldii	False	True
Nipponocypris_temminckii	False	True
Candidia_barbata	False	True
Leptobarbus_hoevenii	False	True
Psilorhynchus_sucatio	False	True
Psilorhynchus_homaloptera	False	True
Schizothorax_waltoni	False	True
Chuanchia_labiosa	False	True
Gymnocypris_eckloni	False	True
Gymnocypris_waddellii	False	True
Barbus_barbus	False	True
Acrossocheilus_paradoxus	False	True
Onychostoma_barbatulum	False	True
Onychostoma_ovale	False	True
Acrossocheilus_monticola	False	True
Spinibarbus_hollandi	False	True
Spinibarbus_sinensis	False	True
Tor_sinensis	False	True
Hypselobarbus_jerdoni	False	True
Barbus_leonensis	False	True
Barbus_fasciolatus	False	True
Barbus_callipterus	False	True
Systomus_orphoides	False	True
Pethia_conchonius	False	True
Pethia_ticto	False	True
Pethia_nigrofasciata	False	True
Pethia_stoliczkana	False	True
Pethia_phutunio	False	True
Pethia_shalynius	False	True
Pethia_manipurensis	False	True
Pethia_padamya	False	True
Pethia_tiantian	False	True
Pethia_erythromycter	False	True
Pethia_gelius	False	True
Dawkinsia_filamentosa	False	True
Dawkinsia_tambraparniei	False	True
Dawkinsia_arulius	False	True
Dawkinsia_assimilis	False	True
Puntius_chalakkudiensis	False	True
Puntius_bimaculatus	False	True
Puntius_titteya	False	True
Puntius_vittatus	False	True
Puntius_sophore	False	True
Haludaria_fasciata	False	True
Hampala_macrolepidota	False	True
Oreichthys_cosuatis	False	True
Barbonymus_gonionotus	False	True
Sawbwa_resplendens	False	True
Cyclocheilichthys_janthochir	False	True
Carassius_carassius	False	True
Carassius_gibelio	False	True
Cyprinus_carpio	False	True
Sinocyclocheilus_grahami	False	True
Sinocyclocheilus_qiubeiensis	False	True
Sinocyclocheilus_yimenensis	False	True
Sinocyclocheilus_tingi	False	True
Sinocyclocheilus_anophthalmus	False	True
Sinocyclocheilus_maculatus	False	True
Sinocyclocheilus_yangzongensis	False	True
Sinocyclocheilus_purpureus	False	True
Sinocyclocheilus_macrolepis	False	True
Sinocyclocheilus_xunlensis	False	True
Sinocyclocheilus_macrophthalmus	False	True
Sinocyclocheilus_microphthalmus	False	True
Sinocyclocheilus_furcodorsalis	False	True
Sinocyclocheilus_jiuxuensis	False	True
Sinocyclocheilus_rhinocerous	False	True
Sinocyclocheilus_jii	False	True
Garra_fasciacauda	False	True
Paracrossochilus_vittatus	False	True
Garra_spilota	False	True
Garra_kempi	False	True
Phreatichthys_andruzzii	False	True
Garra_makiensis	False	True
Garra_congoensis	False	True
Garra_ornata	False	True
Garra_waterloti	False	True
Garra_rufa	False	True
Garra_nasuta	False	True
Garra_lamta	False	True
Garra_orientalis	False	True
Garra_mirofrontis	False	True
Garra_fuliginosa	False	True
Garra_lissorhynchus	False	True
Garra_flavatra	False	True
Garra_ceylonensis	False	True
Garra_mullya	False	True
Garra_bicornuta	False	True
Garra_tengchongensis	False	True
Pseudocrossocheilus_nigrovittatus	False	True
Pseudocrossocheilus_longibullus	False	True
Pseudocrossocheilus_bamaensis	False	True
Pseudocrossocheilus_papillolabrus	False	True
Pseudocrossocheilus_tridentis	False	True
Ptychidio_jordani	False	True
Pseudogyrinocheilus_prochilus	False	True
Qianlabeo_striatus	False	True
Pseudocrossocheilus_liuchengensis	False	True
Semilabeo_notabilis	False	True
Semilabeo_obscurus	False	True
Parasinilabeo_assimilis	False	True
Hongshuia_paoli	False	True
Sinocrossocheilus_megalophthalmus	False	True
Rectoris_posehensis	False	True
Discogobio_brachyphysallidos	False	True
Discogobio_macrophysallidos	False	True
Discogobio_tetrabarbatus	False	True
Discocheilus_wui	False	True
Discolabeo_wuluoheensis	False	True
Discogobio_yunnanensis	False	True
Mekongina_erythrospila	False	True
Bangana_tonkinensis	False	True
Placocheilus_cryptonemus	False	True
Garra_micropulvinus	False	True
Bangana_lemassoni	False	True
Cirrhinus_molitorella	False	True
Barbichthys_laevis	False	True
Osteochilus_microcephalus	False	True
Osteochilus_vittatus	False	True
Osteochilus_salsburyi	False	True
Osteochilus_lini	False	True
Osteochilus_waandersii	False	True
Labiobarbus_ocellatus	False	True
Labiobarbus_lineatus	False	True
Labiobarbus_siamensis	False	True
Thynnichthys_thynnoides	False	True
Henicorhynchus_siamensis	False	True
Henicorhynchus_lobatus	False	True
Henicorhynchus_ornatipinnis	False	True
Henicorhynchus_lineatus	False	True
Crossocheilus_reticulatus	False	True
Crossocheilus_nigriloba	False	True
Crossocheilus_oblongus	False	True
Epalzeorhynchos_bicolor	False	True
Labeo_cyclorhynchus	False	True
Labeo_forskalii	False	True
Labeo_parvus	False	True
Labeo_niloticus	False	True
Labeo_horie	False	True
Labeo_senegalensis	False	True
Labeo_weeksii	False	True
Labeo_batesii	False	True
Labeo_calbasu	False	True
Labeo_chrysophekadion	False	True
Labeo_angra	False	True
Labeo_rohita	False	True
Labeo_stolizkae	False	True
Cirrhinus_mrigala	False	True
Cirrhinus_cirrhosus	False	True
Labeo_yunnanensis	False	True
Cirrhinus_microlepis	False	True
Labeo_boga	False	True
Bangana_dero	False	True
Labeo_bata	False	True
Incisilabeo_behri	False	True
Devario_malabaricus	False	True
Devario_pathirana	False	True
Devario_devario	False	True
Devario_xyrops	False	True
Devario_aequipinnatus	False	True
Devario_chrysotaeniatus	False	True
Devario_apogon	False	True
Devario_laoensis	False	True
Devario_kakhienensis	False	True
Devario_regina	False	True
Devario_annandalei	False	True
Devario_shanensis	False	True
Devario_sondhii	False	True
Microrasbora_rubescens	False	True
Betadevario_ramachandrani	False	True
Chela_cachius	False	True
Laubuca_caeruleostigmata	False	True
Laubuca_dadiburjori	False	True
Microdevario_gatesi	False	True
Microdevario_kubotai	False	True
Danio_rerio	False	True
Danio_kyathit	False	True
Danio_tinwini	False	True
Danio_nigrofasciatus	False	True
Danio_albolineatus	False	True
Danio_roseus	False	True
Danio_kerri	False	True
Danio_aesculapii	False	True
Danio_erythromicron	False	True
Danio_margaritatus	False	True
Danio_choprae	False	True
Danio_dangila	False	True
Danio_meghalayensis	False	True
Danio_feegradei	False	True
Danionella_dracula	False	True
Danionella_mirifica	False	True
Esomus_metallicus	False	True
Esomus_longimanus	False	True
Esomus_caudiocellatus	False	True
Esomus_ahli	False	True
Trigonostigma_hengeli	False	True
Trigonostigma_heteromorpha	False	True
Brevibora_dorsiocellata	False	True
Rasbora_elegans	False	True
Rasbora_sumatrana	False	True
Rasbora_hobelmani	False	True
Rasbora_paviana	False	True
Rasbora_vulgaris	False	True
Rasbora_tubbi	False	True
Rasbora_rubrodorsalis	False	True
Rasbora_steineri	False	True
Rasbora_meinkeni	False	True
Rasbora_trilineata	False	True
Rasbosoma_spilocerca	False	True
Rasbora_borapetensis	False	True
Rasbora_dusonensis	False	True
Rasbora_aurotaenia	False	True
Rasbora_argyrotaenia	False	True
Rasbora_kottelati	False	True
Rasbora_kalochroma	False	True
Rasbora_einthovenii	False	True
Rasbora_jacobsoni	False	True
Rasbora_bankanensis	False	True
Rasbora_cephalotaenia	False	True
Boraras_urophthalmoides	False	True
Boraras_brigittae	False	True
Boraras_merah	False	True
Boraras_maculatus	False	True
Trigonopoma_pauciperforatum	False	True
Trigonopoma_gracile	False	True
Pectenocypris_korthausae	False	True
Kottelatia_brittani	False	True
Horadandia_atukorali	False	True
Rasboroides_vaterifloris	False	True
Rasbora_daniconius	False	True
Amblypharyngodon_mola	False	True
Amblypharyngodon_chulabhornae	False	True
Raiamas_salmolucius	False	True
Opsaridium_ubangiense	False	True
Opsaridium_boweni	False	True
Opsaridium_peringueyi	False	True
Chelaethiops_bibie	False	True
Chelaethiops_elongatus	False	True
Neobola_bottegoi	False	True
Leptocypris_niloticus	False	True
Raiamas_buchholzi	False	True
Raiamas_christyi	False	True
Rastrineobola_argentea	False	True
Engraulicypris_sardella	False	True
Raiamas_senegalensis	False	True
Raiamas_batesii	False	True
Raiamas_bola	False	True
Barilius_barila	False	True
Barilius_vagra	False	True
Barilius_caudiocellatus	False	True
Opsarius_pulchellus	False	True
Barilius_bendelisis	False	True
Barilius_canarensis	False	True
Raiamas_guttatus	False	True
Cabdio_morar	False	True
Securicula_gora	False	True
Luciosoma_bleekeri	False	True
Luciosoma_setigerum	False	True
Opsarius_koratensis	False	True
Malayochela_maassi	False	True
Barbatula_barbatula	False	True
Barbatula_toni	False	True
Triplophysa_rosa	False	True
Triplophysa_gundriseri	False	True
Tuberoschistura_baenzigeri	False	True
Lefua_costata	False	True
Lefua_echigonia	False	True
Oreonectes_platycephalus	False	True
Traccatichthys_pulcher	False	True
Schistura_balteata	False	True
Schistura_savona	False	True
Formosania_fascicauda	False	True
Vanmanenia_pingchowensis	False	True
Pseudogastromyzon_fangi	False	True
Pseudogastromyzon_cheni	False	True
Beaufortia_szechuanensis	False	True
Vanmanenia_caldwelli	False	True
Sewellia_lineolata	False	True
Homaloptera_leonardi	False	True
Homaloptera_parclitella	False	True
Ellopostoma_mystax	False	True
Cobitis_shikokuensis	False	True
Cobitis_takatsuensis	False	True
Cobitis_striata	False	True
Cobitis_biwae	False	True
Misgurnus_anguillicaudatus	False	True
Misgurnus_nikolskyi	False	True
Canthophrys_gongota	False	True
Pangio_oblonga	False	True
Vaillantella_maassi	False	True
Yasuhikotakia_morleti	False	True
Syncrossus_beauforti	False	True
Sinibotia_robusta	False	True
Sinibotia_superciliaris	False	True
Chromobotia_macracanthus	False	True
Botia_dario	False	True
Leptobotia_pellegrini	False	True
Parabotia_lijiangensis	False	True
Parabotia_banarescui	False	True
Parabotia_bimaculata	False	True
Gyrinocheilus_pennocki	False	True
Gyrinocheilus_aymonieri	False	True
Catostomus_commersonii	False	True
Minytrema_melanops	False	True
Hypentelium_nigricans	False	True
Cycleptus_elongatus	False	True
Myxocyprinus_asiaticus	False	True
Astyanax_mexicanus	False	True
Paracheirodon_innesi	False	True
Chalceus_macrolepidotus	False	True
Ctenolucius_hujeta	False	True
Nannostomus_beckfordi	False	True
Hoplias_malabaricus	False	True
Phenacogrammus_interruptus	False	True
Brycinus_macrolepidotus	False	True
Hepsetus_odoe	False	True
Semaprochilodus_insignis	False	True
Hydrolycus_armatus	False	True
Characidium_fasciatum	False	True
Distichodus_antonii	False	True
Lacantunia_enigmatica	False	True
Parailia_pellucida	False	True
Malapterurus_microstoma	False	True
Leiarius_pictus	False	True
Microglanis_iheringi	False	True
Ictalurus_punctatus	False	True
Ameiurus_nebulosus	False	True
Cranoglanis_bouderius	False	True
Ariopsis_felis	False	True
Pangasianodon_hypophthalmus	False	True
Glyptothorax_trilineatus	False	True
Gagata_dolichonema	False	True
Bagarius_yarrelli	False	True
Pseudexostoma_yunnanense	False	True
Pareuchiloglanis_gracilicaudata	False	True
Creteuchiloglanis_kamengensis	False	True
Euchiloglanis_kishinouyei	False	True
Glaridoglanis_andersonii	False	True
Exostoma_labiatum	False	True
Glyptosternon_maculatum	False	True
Pseudecheneis_sulcata	False	True
Liobagrus_anguillicauda	False	True
Pseudobagrus_tokiensis	False	True
Kryptopterus_minor	False	True
Silurus_meridionalis	False	True
Clarias_gariepinus	False	True
Diplomystes_nahuelbutaensis	False	True
Corydoras_rabauti	False	True
Brachyhypopomus_gauderio	False	True
Rhamphichthys_marmoratus	False	True
Gymnotus_cylindricus	False	True
Apteronotus_albifrons	False	True
Eigenmannia_virescens	False	True
Chanos_chanos	False	True
Parakneria_cameronensis	False	True
Gonorynchus_greyi	False	True
Denticeps_clupeoides	False	True
Alosa_alosa	False	True
Alosa_fallax	False	True
Sardina_pilchardus	False	True
Sardinella_maderensis	False	True
Sardinella_aurita	False	True
Dorosoma_cepedianum	False	True
Sprattus_sprattus	False	True
Clupea_harengus	False	True
Engraulis_encrasicolus	False	True
Engraulis_japonicus	True	False
Coilia_dussumieri	False	True
Alepocephalus_antipodianus	True	False
Alepocephalus_owstoni	True	False
Alepocephalus_bicolor	True	False
Alepocephalus_agassizii	True	False
Talismania_longifilis	True	False
Sagamichthys_abei	True	False
Osteoglossum_bicirrhosum	False	True
Arapaima_gigas	False	True
Mormyrops_anguilloides	False	True
Ophisurus_macrorhynchos	True	False
Conger_japonicus	True	False
Conger_conger	True	False
Rhinomuraena_quaesita	True	False
Strophidon_sathete	False	True
Gymnothorax_polygonius	True	False
Gymnothorax_reticularis	True	False
Gymnothorax_favagineus	True	False
Muraena_helena	True	False
Muraena_augusti	True	False
Muraena_melanotis	True	False
Gymnothorax_miliaris	True	False
Enchelycore_anatina	True	False
Gymnothorax_bacalladoi	True	False
Gymnothorax_maderensis	True	False
Muraena_robusta	True	False
Gymnothorax_unicolor	True	False
Anguilla_japonica	False	True
Anguilla_anguilla	False	True
Eurypharynx_pelecanoides	True	False
Histiobranchus_bathybius	True	False
Notacanthus_bonaparte	True	False
Halosauropsis_macrochir	True	False
Elops_saurus	False	True
Megalops_atlanticus	False	True
Lepisosteus_osseus	False	True
Lepisosteus_oculatus	False	True
Atractosteus_tropicus	False	True
Amia_calva	False	True
Huso_huso	False	True
Polyodon_spathula	False	True
